9 16
BGGGWWWWWWWWGGGG
GGMGWGGGGGGWGGGG
GGGGWGGGFGGWGGGG
GGGGWGGGGGGWGGGG
GGGGWGGGGGGWGGMG
GGGGWWWWWWWWGGGG
GGGGGGGGGGGGGGGG
GGGGGGGG-GGGGGGG
GGGGGGGGGGGGGGGG